
EA ./textures/wall1.xpm
NO ./textures/wall2.xpm
SO ./textures/wall3.xpm
WE ./textures/wall4.xpm
				C 52,232,235
F 82,235,52

11111111111111111111111111111111111111111
100001    1100000000000000000000000000111
10N001    1000000000000000011000000000011
11000111111000000001110000011000000000011
10011110000000000001100000011111111111111
11000000000000000111100011110000000111111
10000000000000000001000000000000000011111
11111111111111111111111111111111111111111