
EA ./path_to_the_east_texture
NO ./path_to_the_north_texture
SO ./path_to_the_south_texture
WE ./path_to_the_west_texture
				C 255,30,1
F 220,100,1

11111111111111111111111111111111111111111
100001    1100000000000000000000000000111
10N001    1000000000000000011000000000011
11000111111000000001110000011000000000011
10011110000000000001100000011111111111111
11000000000000000111100011110000000111111
10000000000000000001000000000000000011111
11111111111111111111111111111111111111111