EA ./textures/wall1.xpm
NO ./textures/wall2.xpm
SO ./textures/wall3.xpm
WE ./textures/wall4.xpm
C 52,232,235
F 82,235,52

1111111111
1000000E01
1100111011
1101100011
1111111111