EA ./path_to_the_east_texture
NO ./path_to_the_north_texture
SO ./path_to_the_south_texture
WE ./path_to_the_west_texture
				C 255,30,1
F 220,100,1

1111111111
1000000E01
1100111011
1101100011
1111111111