EA ./textures/gru.xpm
NO ./textures/chock.xpm
SO ./textures/hamster.xpm
WE ./textures/dog.xpm
C 169, 169, 169
F 133, 94, 66

1111111111111111111111111111111
1000001000001000001000001000001
1011101011101011101011101011101
1000101010001010001010001010001
1110101010111010111010111010111
1000100000100000100000100000101
1011101110101110101110101110101
100000100000100N001000001000001
1111111111111111111111111111111
1011101011101011101011101011101
1000101010001010001010001010001
1110101010111010111010111010111
1000100000100000100000100000101
1011101110101110101110101110101
1000001000001000001000001000001
1111111111111111111111111111111