EA ./textures/gru.xpm
NO ./textures/chock.xpm
SO ./textures/hamster.xpm
WE ./textures/dog.xpm
C 255,0,0
F 33,33,33

1111111111111111111111111111111
1000001000001000001000001000001
1011101011101011101011101011101
1000101010001010001010001010001
1110101010111010111010111010111
1000100000100000100000100000101
1011101110101110101110101110101
1000001000001W00000000001000001
1111111111111111110111111111111
1011101011101011100011101011101
1000101010001010001010001010001
1110101010111010111010111010111
1000100000100000100000100000101
1011101110101110101110101110101
1000001000001000001000001000001
1111111111111111111111111111111